[console_scripts]


[pyjen.plugins.v1.0]
allview = pyjen.plugins.allview:PluginClass
artifactarchiver = pyjen.plugins.artifactarchiver:PluginClass
artifactdeployer = pyjen.plugins.artifactdeployer:PluginClass
buildblocker = pyjen.plugins.buildblocker:PluginClass
buildtriggerpublisher = pyjen.plugins.buildtriggerpublisher:PluginClass
conditionalbuilder = pyjen.plugins.conditionalbuilder:PluginClass
flexiblepublish = pyjen.plugins.flexiblepublish:PluginClass
folderjob = pyjen.plugins.folderjob:PluginClass
freestylejob = pyjen.plugins.freestylejob:PluginClass
gitscm = pyjen.plugins.gitscm:PluginClass
listview = pyjen.plugins.listview:PluginClass
mavenplugin = pyjen.plugins.mavenplugin:PluginClass
multibranch_pipeline = pyjen.plugins.multibranch_pipeline:PluginClass
multijob = pyjen.plugins.multijob:PluginClass
myview = pyjen.plugins.myview:PluginClass
nestedview = pyjen.plugins.nestedview:PluginClass
nullscm = pyjen.plugins.nullscm:PluginClass
parambuild_string = pyjen.plugins.parambuild_string:PluginClass
parameterizedbuild = pyjen.plugins.parameterizedbuild:PluginClass
paramtrigger = pyjen.plugins.paramtrigger:PluginClass
paramtrigger_buildtrigger = pyjen.plugins.paramtrigger_buildtrigger:PluginClass
paramtrigger_currentbuildparams = pyjen.plugins.paramtrigger_currentbuildparams:PluginClass
pipelinejob = pyjen.plugins.pipelinejob:PluginClass
runcondition_always = pyjen.plugins.runcondition_always:PluginClass
runcondition_and = pyjen.plugins.runcondition_and:PluginClass
runcondition_never = pyjen.plugins.runcondition_never:PluginClass
runcondition_not = pyjen.plugins.runcondition_not:PluginClass
sectionedview = pyjen.plugins.sectionedview:PluginClass
sectionedview_listsection = pyjen.plugins.sectionedview_listsection:PluginClass
sectionedview_textsection = pyjen.plugins.sectionedview_textsection:PluginClass
shellbuilder = pyjen.plugins.shellbuilder:PluginClass
statusview = pyjen.plugins.statusview:PluginClass
subversion = pyjen.plugins.subversion:PluginClass

